NO ./textures/north.xpm
SO ./textures/south.xpm
WE ./textures/west.xpm
EA ./textures/east.xpm
F 20,20,20
C 200,200,200

111111
100001
N00001
111111