NO ./textures/north.xpm
SO ./textures/south.xpm
WE ./textures/west.xpm
EA ./textures/east.xpm
F 20,20,20
C 200,200,200

  111111
 1100001
11000001
100  001
100N 001111
100  000001
11000001111
 1111111