F 160,160,160
W 153,0,0
C 192,192,192

11111
10001
10001
10001
100N1
11111
